OOOOOOOOOOOOOOOOOOOOOOOOOOOOOOOOOOOOOOOOOOOOOOOOOO
O    OOOOOO    OOOOOO    OO       OO     OO      O
O    OOOOOO    OOOOOO    OO       OO     OO      O
O    OOOOOO    OOOOOO    OO       OO     OO      O
OOOOOOOOOOOOOOOOOOOOO    OO       OO     OO      O
OOOOOOOOOOOOOOOOOOOOOOOOOOO       OO     OOOOOOOOO
OOOOOOOOOOOOOOOOOOOOOOOOOOOOOOOOOOOOOOOOOOOOOOOOOO
OOOOOOOOOOOOOOOOO  OO    OOOOOOOOOOOOOOOOOO      O
OOOOOOOOOOOOOOOOO  OO    OO       OO     OO      O
OOOOOOOOOOOOOOOOO  OO    OO       OO     OO      O
O    OOOOOO    OO  OO    OO       OO     OO      O
O    OOOOOO    OO  OO    OOOOOOOOOOO     OO      O
O    OOOOOO    OO  OO    OOOOOOOOOOO     OOOOOOOOO
O    OOOOOO    OOOOOOOOOOOO       OO     OOOOOOOOO
OOOOOOOOOOOOOOOOOOOOOOOOOOO       OOOOOOOOO      O
OOOOOOOOOOOOOOOOO  OO    OO       OOOOOOOOO      O
O      OO      OO  OO    OO       OO     OO      O
O      OO      OO  OO    OO       OO     OO      O
O      OO      OO  OO    OO       OO     OO      O
O      OO      OO  OO    OO       OO     OO      O
O      OO      OO  OO    OO       OO     OO      O
OOOOOOOOOOOOOOOOOOOOOOOOOOOOOOOOOOOOOOOOOOOOOOOOOO
OOOOOOOOOOOOOOOOOOOOOOOOOOOOOOOOOOOOOOOOOOOOOOOOOO
O    OO     OO     OO      OOOOOOO       OO      O
O    OO     OO     OO      OOOOOOO       OO      O
O    OO     OO     OO      OOOOOOO       OOOOOOOOO
O    OO     OO     OOOOOOOOOOOOOOO       OOOOOOOOO
O    OO     OO     OOOOOOOOOOOOOOO       OO      O
O    OO     OO     OO      OOOOOOOOOOOOOOOO      O
O    OO     OO     OO      OOOOOOOOOOOOOOOO      O
OOOOOOOOOOOOOOOOOOOOO      OOOOOOO       OOOOOOOOO
OOOOOOOOOOOOOOOOOOOOO      OOOOOOO       OOOOOOOOO
O    OO     OO     OOOOOOOOOO   OO       OO      O
O    OO     OO     OOOOOOOOOO   OO       OO      O
O    OO     OOOOOOOOO      OO   OO       OO      O
OOOOOOOOOOOOOOOOOOOOO      OO   OO       OO      O
OOOOOOOOOOOOOO     OOOOOOOOOOOOOOOOOOOOOOOOOOOOOOO
O    OO     OO     OOOOOOOOOOOOOOOOOOOOOOOOOOOOOOO
O    OO     OO     OO      OO     OO     OO      O
O    OO     OO     OO      OO     OO     OO      O
O    OO     OO     OO      OO     OO     OO      O
OOOOOOOOOOOOOOOOOOOOO      OO     OO     OO      O
OOOOOOOOOOOOOOOOOOOOO      OO     OOOOOOOOOOOOOOOO
O       OO  OO     OOOOOOOOOOOOOOOOOOOOOOOOOOOOOOO
O       OO  OO     OOOOOOOOOOOOOOOOO  OO   OO    O
O       OO  OO     OO      OO     OO  OO   OO    O
O       OO  OO     OO      OO     OO  OO   OO    O
O       OO  OO     OO      OO     OO  OO   OO    O
O       OO  OO     OO      OO     OO  OO   OO    O
OOOOOOOOOOOOOOOOOOOOOOOOOOOOOOOOOOOOOOOOOOOOOOOOOO
